10
10
X1X1000101010102X1X1
X10004040404040402X1
00040404040404040402
03040404040404040405
03040404040404040405
06040404040404040408
0906070707070707080B
X1090A0A0A0A0A0A0BX1
X1X1X1X1X1X1X1X1X1X1
X1X1X1X1X1X1X1X1X1X1
