25
25
X1X1X1X1X1X1X1X1X1X1X1X1X1X1X1X1X1X1X1X1X1X1X1X1X1
X1X1X1X1X1X1X1X1X1X1X1X1X1X1X1X1X1X1X1X1X1X1X1X1X1
X1X1X1X1X1X1X1X1X1X1X1X1X1X1X1X1X1X1X1X1X1X1X1X1X1
X1X1X1X1X1X100010101010102X1X1X1X1X1X1X1X1X1X1X1X1
X1X1X1X1X1000404040404040402X1X1X1X1X1X1X1X1X1X1X1
X1X1X1X10004040404040404040402X1X1X1X1X1X1X1X1X1X1
X1X1X1X10304040404040404040405X1X1X1X1X1X1X1X1X1X1
X1X1X1X10304040404040404040405X1X1X1X1X1X1X1X1X1X1
X1X1X1X10304040404040404040405X1X1X1X1X1X1X1X1X1X1
X1X1X1X10304040404040404040405X1X1X1X1X1X1X1X1X1X1
X1X1X1X10604040404040404040408X1X1X1X1X1X1X1X1X1X1
X1X1X1X1090304040404040404050BX1X1X1X1X1X1X1X1X1X1
X1X1X1X1X1060707070707070708X1X1X1X1X1X1X1X1X1X1X1
X1X1X1X1X1090A0A0A0A0A0A0A0BX1X1X1X1X1X1X1X1X1X1X1
X1X1X1X1X1X1X1X1X1X1X1X1X1X1X1X1X1X1X1X1X1X1X1X1X1
X1X1X1X1X1X1X1X1X1X1X1X1X1X1X1X1X1X1X1X1X1X1X1X1X1
X1X1X1X1X1X1X1X1X1X1X1X1X1X1X1X1X1X1X1X1X1X1X1X1X1
X1X1X1X1X1X1X1X1X1X1X1X1X1X1X1X1X1X1X1X1X1X1X1X1X1
X1X1X1X1X1X1X1X1X1X1X1X1X1X1X1X1X1X1X1X1X1X1X1X1X1
X1X1X1X1X1X1X1X1X1X1X1X1X1X1X1X1X1X1X1X1X1X1X1X1X1
X1X1X1X1X1X1X1X1X1X1X1X1X1X1X1X1X1X1X1X1X1X1X1X1X1
X1X1X1X1X1X1X1X1X1X1X1X1X1X1X1X1X1X1X1X1X1X1X1X1X1
X1X1X1X1X1X1X1X1X1X1X1X1X1X1X1X1X1X1X1X1X1X1X1X1X1
X1X1X1X1X1X1X1X1X1X1X1X1X1X1X1X1X1X1X1X1X1X1X1X1X1
X1X1X1X1X1X1X1X1X1X1X1X1X1X1X1X1X1X1X1X1X1X1X1X1X1
