32
16
X1X1X1X1X1X1X1X1X1X1X1X1X1X1X1X1X1X1X1X1X1X1X1X1X1X1X1X1X1X1X1X1
X1X1X1X1X1X1X1050505X1X1X1X1X1X1X1X1X1X1X1X1X1X1X1X1X1X1X1X1X1X1
X1X1X1X1X1X1X1050505X1X1X1X1X1X1X1X1X1X1X1X1X1X1X1X1X1X1X1X1X1X1
X1X1X1X1X1X10505040505X1X1X1X1X1X1X1X1X1X1X1X1050505X1X1X1X1X1X1
X1X1X1X1X1X10505040505X1X1X1X1X1X1X1X1X1X1X1X1050505X1X1X1X1X1X1
X1X1X1X1X1X1X1X104X1X1X1X1X1X1X1X1X1X1X1X1X10505040505X1X1X1X1X1
X1X1X1X1X1X1X1X104X1X1X1X1X1X1X1X1X1X1X1X1X10505040505X1X1X1X1X1
X1X1X1X1X1X1X1X104X1X1X1X1X1X1X1X1X1X1X1X1X1X1X104X1X1X1X1X1X1X1
X1000000000000000000000000000000000000X1X1X1X1X104X1X1X1X1X1X1X1
0001010101010101010101010101010101010100000000000000000000000000
0101010101010101010101010101010101010101010101010101010101010101
0101010101010101010101010101010101010101010101010101010101010101
0102020202020202020202020202020202020201010101010101010101010101
0202020202020202020202020202020202020202020202020202020202020202
0202020202020202020202020202020202020202020202020202020202020202
0202020202020202020202020202020202020202020202020202020202020202
