20
20
X1X1X1X1X1X1X1X1X1X1X1X1X1X1X1X1X1X1X1X1
X1X1X1X1X1X1X1X1X1X1X1X1X1X1X1X1X1X1X1X1
X1X1X1X1X1X1X1X1X1X1X1X1X1X1X1X1X1X1X1X1
X1X1X1X1X1X1X1X1X1X1X1X1X1X1X1X1X1X1X1X1
X1X100000000000000X1X1X1X1X1X1X1X1X1X1X1
0000010101010101010000000000000000000000
0101010101010101010101010101010101010101
010101011B1B1B01010101010101010101010101
1B1B1B1B1B1B1B1B1B1B1B1B1B1B1B1B1B1B1B1B
1B1B1B1B1B1B1B1B1B1B1B1B1B1B1B1B1B1B1B1B
1B1B1B1B1B1B1B1BX1X1X11B1B1B1B1B1B1B1B1B
1B1B1B1B1B1B1BX1X1X1X1X1X1X11B1B1B1B1B1B
1B1B1B1B1B1BX1X1X1X1X1X1X1X1X1X1X1X11B1B
1B1B1B1B1BX1X1X1X1X1X1X1X1X1X1X1X1X1X1X1
1B1B1B1B1BX1X1X1X1X1X1X1X1X1X1X1X1X1X1X1
1B1B1B1B1BX1X1X1X1X1X1X1X1X1X1X1X1X1X1X1
1B1B1B1B1B1BX1X1X1X1X1X1X1X1X1X1X1X1X1X1
1B1B1B1B1B1BX1X1X1X1X1X1X1X1X1X1X1X1X1X1
1B1B1B1B1B1B1B1BX1X1X1X1X1X1X11B1B1B1B1B
1B1B1B1B1B1B1B1B1B1B1B1B1B1B1B1B1B1B1B1B
