25
25
04040404040404040404040404040404040404040404040404
04040404040404000101010204040404040404040404040404
04040404040404030404040504040404040404040404040404
04040404040404030404040504040404040404040404040404
04040404040404030404040504040404040404040404040404
04040404040404060707070804040404040404040404040404
04040404040404090404040404040404040404040404040404
04040404040404090404040404040404040404040404040404
04040404040404090404040404040404040404040404040404
04040404040404040404040404040404040404040404040404
04040404040404040404040404040404040404040404040404
04040404040404040404040404040404040404040404040404
04040404040404040404040404040404040404040404040404
04040404040404040404040404040404040404040404040404
04040404040404040404040404040404040404040404040404
04040404040404040404040404040404040404040404040404
04040404040404040404040404040404040404040404040404
04040404040404040404040404040404040404040404040404
04040404040404040404040404040404040404040404040404
04040404040404040404040404040404040404040404040404
04040404040404040404040404040404040404040404040404
04040404040404040404040404040404040404040404040404
04040404040404040404040404040404040404040404040404
04040404040404040404040404040404040404040404040404
04040404040404040404040404040404040404040404040404
